000000000000000000000000
000000000000000000000000
000000000000000000000000
000000000000000000000000
000000000000000000000000
111211116615001111111111
123512211005010000010000
600000000015001000101000
100000001605000111000100
000000110005000000000000
600100000605000000001111
200000000005000000010000
000060100225514060100000
001000000005442201100000
000020000006000000500000
010600000005000012210012
002000200115200111111111
000010000005116110060111
111111011115110000110001
111000011115111111111161
110001111115110600060001
110100011115100111111111
000111011115101111111111
011111011115061111111111
000000006656500111111111
100000000566650611111111
110000605005005001111111
111000050005000560111111
111000510605000050011111
600005000005000005600111
011156000015001000510601
600005001005600005111001
111100500005000051110011
600000050005000511110601
111111005006005111001001
600000000510156666000611
111111110000051111121111
000000000001052141241333
005555555555555555555555
100521200000000000000000
010511000111111111115100
000510011111111111115060
001511000111000100005001
010511110060010001005000
000511111111111110615160
100511111100011100115002
010511111001001001115300
006511110011100011115002
601511000111111111115160
010510001111111111115003
000511001111110001115000
106511100111110100115160
010511110001100110015001
000511111100001111005001
011511111111111111100500
600006006006006006005001
111111111111111111115101
000000000000000000000000
555005555550000555555550
500000000000000000000000
500100000550000000000111
500000055006005500010400
500005500006000055000000
500550000006000005500000
555000000006100000050000
600600000100000000000055
005500000001000000005500
060055000000010000044000
100005550000000005500000
000605155000000550000006
001005400550655000000006
000005000000000000000166
100005000000000000001666
000105000000000000016661
000000000000000000166666
111451110055112000231000
000000000055005000100001
066600000155000101000011
000000111055000040000100
014100000055000000002000
000006660055000060040000
000001210055000114600001
000000000055100000000102
000000600055110000000000
013100000055145321120005
000000011155000000000000
006660000500000006660000
311215111100111315411211
000000000000000000000000
000000000066000000000000
000032122101022111111221
000100000000000000006000
066000000600000000600060
111110000200001111111111
111111100000011000000000
000000000060100006660000
800000060001100001110000
777777111000000000000006
555555555555555555555555
555555555555555555555555
