000000000000000000000000
000000000000000000000000
000000000000000000000000
000000000000000000000000
000000000000000000000000
111111111111111111111111
231230131111000120132010
302121111020032300132011
133200121023101333302002
223132222033231030201220
313211312032133323000103
221123000321231112013233
131221311332013303211102
133213003102122201033303
211002233302100133221011
131011212033203130322313
023012120320022102011033
313002312233120021321200
212333132003211101212201
132011200222032203012121
312003131013012123232200
231323301103210102102312
122222201110221200131230
212010222220012320210332
130121123231012032230112
220001032332310000021121
111113231123111110302012
213002113322331213022033
231022210333023331012212
202233012311103101200213
012001131221301031000223
230101202222130122322110
320210313211033001201333
132223001011033231321212
231030202102202310032130
201000222333131111333132
230021003122320132321322
322020110220013132301313
110010121213232231103311
223231031231003313213023
000311313222122311200123
223303220022112331121022
130112222113130330200020
220200113121300213003323
112121110322102230301233
033031030112233131101111
110331221212201223233003
021313122231113232032022
021221211021020212301311
030030133233123132002120
121312101023011022112102
310330221321322113210012
031300201203111010203010
000332220223222011301203
110010231133031231323122
212110320011220303213202
000031003110102111331301
032030301011332201200023
003120013333200221213012
203003031232111133133300
002311003031001033200100
011331330333111023302303
110310323120300113110132
211120201212101000032101
213222201113210332212201
111310001021032231032222
013023200201123110213220
301121233230002212122100
221200322202112231223301
230013113033002231123303
023132131030320302202223
232212123003302133200121
011110110320321221131130
010232200113101232301220
231303032110322211311112
320213222030030102103130
012020311331211322132111
120301323010020202210223
021033133133300000223020
232333120122323322132020
111300333110013330211201
123133120211212023221320
213210330021020333323202
223132020221030332023103
333233100103013230010230
233112212320312011033131
222302300233003222013331
103213110122330301002331
121002233010203011232023
200122310213201222321013
232100313123110013333321
000303213133021033002111
131111321100330330031103
230331222321200111221000
311111303222133332230302
021021212302001002201201
123221330212321130313122
013210122023233101122301
555555555555555555555555
555555555555555555555555
