000000000000000000000000
000000000000000000000000
000000000000000000000000
000000000000000000000000
000000000000000000000000
111111111111111110000000
600000600000000600000000
111101011111111111111110
100001010000060011111116
100111100111111001111000
101111001116611100110611
106000611116611110600111
111111111111011111001111
111111111000000000011111
111111600011111111111111
111111111000011111111111
111111110051001111111111
110000000151000000000000
600111111151011611101011
101106011150000000000001
100001000150000100000161
111111116151011001060011
111111000150000000010001
111110011151011101111101
100000111111000000000004
110061111111111111110011
111000111111110060000111
111110000060000011111111
111111111101111111111111
111111111101111111111111
100000000000000000000002
111011110111111011111101
111011110111111011111101
111000000011111011110001
111111100001111011100101
111111110100006001001101
111111110111111011011101
111111110111111011011111
111111110111111011001111
111111110111111011100611
300000000000000000000004
101111116111111111111111
100111111111111111111101
110000000000001111111101
100111116111111111111101
110000111100061106611101
100110000001111001111161
110011111111111100111161
100100010000161161111101
110001000110000000000001
100111111111111111111011
110000000000000060011001
111111111111111111110011
100006666666666661100111
001111111111111111001111
100111111111111110011111
001111111111111100111111
100111111110000001111111
001111111100111111111111
100111110001111111111111
001111000111111111111111
100000060060000060000003
111111111101111111111111
000000000000000000006000
000000001241210000000660
000111000000000000000060
000000006000001240001000
111000011000000000000000
000000000000000000500000
006001110000000000000000
001000000000000150000000
000000000110000000000000
000001400000000000000000
400000000000050000000000
111111111100111111111111
111111111001111111111111
111111000011110000000000
111100001111110000000000
100001111111110000017781
100100111100000001001111
110110011500001000000000
110011001502000001000003
110111100500000000000000
100111001500000010000100
110111100500050000100000
116111001500000000000000
111111100501450000000100
110000061500000000000000
100111111111110011111111
110011111110000111111111
100111111000111111111111
110001110011111111111111
111100111000600600000001
111001111111111111111001
111100111111111111110001
111110611111111006000111
111111000111000001111111
111111110000011111111111
555555555555555555555555
555555555555555555555555
